#############
#F.....#....F#
#..###.#.###.#
#.....P......#
##.##   ##.##
#....###....#
#.###S#S###.#
#.....T.....#
#############
